1111111111111
1001000001C01
1000011111001
1P0011E000001
1111111111111