11111111111111111111
1P000B000100000C0001
10000000010000000001
100000000C0000000001
1000000000111000B001
10110B00000001111001
100000000C00100E0001
10000000000100000001
11111111111111111111