1111111111111
1001000000CB1
1B00011111001
1PB011E000001
1111111111111